2 21 19
###################
#@             #  #
#              #  #
#  ##########  #  #
#  #     #  #  #  #
#  #     #  #  #  #
#  #  #  #  #  #  #
#     #     #  #  #
#     #     #  #  #
#  ##########  #  #
#  ##########  #  #
#  ##########  #  #
#           #     #
#           #     #
################  #
#                 #
#                 #
#  #  #############
#  #              #
#  #            ^ #
###################
###################
#@          #     #
#           #     #
#  #######  ####  #
#  #     #     #  #
#  #     #     #  #
#  #  ####  #  #  #
#  #     #  #     #
#  #     #  #     #
#  ####  #  #######
#  ####  #  #######
#  ####  #  #######
#  #  #     #     #
#  #  #     #     #
#  #  #######  #  #
#  #           #  #
#  #           #  #
#  #  ##########  #
#     #           #
#     # %         #
###################
